60 60 60 60 84 84 60 61 62 64 64 100 101 64 64 64 
60 60 60 60 60 60 60 109 110 61 64 100 101 64 64 64 
209 209 209 209 60 84 84 55 84 109 40 100 173 41 55 55 
180 181 183 182 84 55 55 55 55 55 96 96 96 55 55 55 
55 55 108 55 55 55 55 55 55 96 96 96 96 96 96 55 
313 314 108 312 314 55 55 55 96 96 96 96 96 96 96 55 
361 362 108 360 337 313 314 55 55 96 96 96 96 96 55 55 
113 137 108 9 360 361 337 313 313 314 25 55 55 55 55 55 
108 108 108 137 137 137 360 361 361 362 25 312 313 313 314 55 
137 137 108 108 108 137 113 137 9 137 25 360 361 361 337 313 
137 112 137 137 108 108 108 108 108 137 25 137 137 137 360 361 
313 314 137 137 9 137 137 137 108 108 209 108 108 137 137 9 
361 337 313 314 137 137 137 112 137 137 25 137 108 108 108 108 
114 360 361 337 313 313 313 314 137 137 25 137 137 137 137 137 
114 244 114 360 361 361 361 337 313 314 25 137 137 112 137 137 
114 244 114 244 114 244 114 360 361 362 25 312 313 313 313 313 
